                              
                              
                              
                              
1                            1
1                            1
11                           1
1111                        11
1111111                      1
111                         11
11111111111111111            1
111111111111111111111111111111
